NO ./textures/NO.xpm
SO 			./textures/SO.xpm
EA ./textures/EA.xpm
WE ./textures/WE.xpm

C 76, 52, 100
F 76,0,													            							255

1111111
1000001
1111101
   10001
  1000001      111111111111
 100000001     100000000001
100000S00011111000000000001
100000000000000000011111111
10000000001111000001
11111001111  1000001  111
    101      1000001  101
    101      1111111  111
1111111