NO ./textures/NO.xpm
SO ./textures/SO.xpm
WE ./textures/WE.xpm
EA ./textures/EA.xpm

C 9,8,14
F 35,38,46

1111111
1E00001
1111101
   10001
  1000001      111111111111
 100000001     100000000001
100000000011111100000000001
100000000000100000011111111
10000000001111000001
11111011111  1000001
    101      1000001
    101      1111111
    111