NO ./textures/NO.xpm
SO 			./textures/SO.xpm
WE ./textures/WE.xpm
EA ./textures/EA.xpm

C 108, 100, 43

F 35,38,46

1111111
1000001
1111101
   10001
  1000001      111111111111
 100000001     100000000001
100000000011111000000000001
10000000S000000000011111111
10000000001111000001
11111001111  1000001  111
    101      1000001  101
    101      1111111  111
    111










111                      			        1111111
101    						1
111