NO ./textures/NO.xpm
SO 			./textures/SO.xpm
EA ./textures/EA.xpm
WE ./textures/WE.xpm


C 76, 52, 100
F 76,52,100
11111111111111111111111111111111111111111111111111
10100000011000000000111101010001001000010001000001
11010100100000000101001001000100101010000000000001
10001001100000000010111100110001100000001000111001
10110000000100000000001000000000000000011000100101
11000011100010100101001000000000011100010101010011
10100000001000011000000010000100110001100100000011
11000100001000001000000000001010100010010001000001
10000000100001010000010000010000010000000011001101
10000000100011100000000100000000000010110010000001
10001010100000111110001000000000000000000001010011
10010100000001000010011000010000100001001000000101
10001000010010001010001100001000010001110010100001
11001010000000100101010100100010000001011000100001
11000000011100010000001100010101010010000000010001
10000000100011011000000001000001000000000000001001
11101001110000001000000100010010001100100000000001
10000001101000100010000000011010000010000000000111
11000000000001110000000000000011100010000000000011
11000001001000001000000010010100100000110101010001
10000100000000000000000000101000000000000000010001
11001001000000110100110000000110000000000100000011
10000001000000010000111001100111000101100001001001
11101010001100010000011011001100000111010100010001
10110100000100001100000000000100000100100100001001
10000000101000010001100000101101101000000000000011
10001000000010000010000000000110100100100011000001
10000000000110000000101000110101001100000011001011
10000010010000001000010110000100001000000000001011
10100010000000100001000000010001100000011000110001
1100000000110000100S000010000010101000001100001011
10010101000101000011110110000110000001000000010001
11000110011000100000100000000001000101000000000101
10000000010010000101010000000000100010011100000001
10110010000000001000100111100010101001100000001001
10010000000000000100010000000001000100000000010001
10000001000010000100100010001000010000000100110001
10110000010000000000000001000010010000000011010101
10001010100100000000000111010101000100011101000011
10110110001000000100101100101010100001100000100101
11000100100100000011001010001000100000010100000101
10010000010000110000010001010000100000000011001101
10010000000000000001000010010110001010010001011101
10100000001001100100000100100000001000000000001001
10000100011100010100110111110101101000000100000011
10110001000000011000000101001000000010000000010011
10001011000000000100000111000010110100100000100101
10000011000010000100000101100001001000000001101001
10100000000011010101100100000000100001100000000001
11111111111111111111111111111111111111111111111111
