NO ./textures/NO.xpm
SO 			./textures/SO.xpm
EA ./textures/EA.xpm
WE ./textures/WE.xpm

F 14,5,58
C 10,0,10

1111111111111
1E00000000001
1111111111111
